ab-university.info: 	Domain Name is not censored

bdmirror24.net: 	Local Dns Server Returning rrset with rcode set

bdpolitico.com: 	Domain Name is not censored

bdpolitico.com: 	Domain Name is not censored

bdsaradin.com: 	Domain Name is not censored

belovedbd.com: 	Domain Name is not censored

classbd.com: 	Domain Name is not censored

defenseupdatebangladesh.wordpress.com: 	Domain Name is not censored

forum.daffodilvarsity.edu.bd: 	Domain Name is not censored

lookeast.in: 	Domain Name is not censored

m.facebook.com: 	Domain Name is not censored

m.facebook.com: 	Domain Name is not censored

nari.news: 	Domain Name is not censored

shahjalalairport.com: 	Domain Name is not censored

toprichests.com: 	Domain Name is not censored

vidloops.com: 	Domain Name is not censored

www.abuniversity.com: 	Domain Name is not censored

www.abuniversity.edu.bd: 	Invalid Domain Name or Unknown Error Occured

www.abuniversitybd.org: 	Domain Name is not censored

www.ambanuniversity.com: 	Domain Name is not censored

www.americabangladeshuniversity.info: 	Domain Name is not censored

www.americabangladeshuniversity.org: 	Invalid Domain Name or Unknown Error Occured

www.atiurrahman.org: 	Domain Name is not censored

www.banglamonitor.com: 	Domain Name is not censored

www.barta.pw: 	Domain Name is not censored

www.bdnetwork24.com: 	Invalid Domain Name or Unknown Error Occured

www.bitcoin.com.cdn.cloudflare.net: 	Domain Name is not censored

www.generalheadlines.com: 	Domain Name is not censored

www.helootech.com: 	Domain Name is not censored

www.jumlandradio.org: 	Invalid Domain Name or Unknown Error Occured

www.news18.com: 	Domain Name is not censored

www.newsforbd.net: 	Domain Name is not censored

www.onlinebarta247.com: 	Domain Name is not censored

www.purboposhchimbd.news: 	Domain Name is not censored

www.quora.com: 	Domain Name is not censored

www.razniti.net: 	Invalid Domain Name or Unknown Error Occured

www.razniti.net: 	Invalid Domain Name or Unknown Error Occured

www.reportbd24.com: 	Invalid Domain Name or Unknown Error Occured

www.shahjalal-airport.com: 	Domain Name is not censored

www.sheershanews24.com: 	Domain Name is not censored

www.studentstation.com: 	Domain Name is not censored

www.sylhettoday24.com: 	Domain Name is not censored

www.teerofshillong.com: 	Domain Name is not censored

www.teerresult.com: 	Domain Name is not censored

www.thehindu.com: 	Domain Name is not censored

www.worldsrichpeople.com: 	Domain Name is not censored

www.xvideos.com: 	Domain Name is not censored

www.yourarticlelibrary.com: 	Domain Name is not censored

xonox3.wixsite.com: 	Domain Name is not censored

xonox3.wixsite.com: 	Domain Name is not censored

ansarbd.webnode.com: 	Domain Name is not censored

ansarulkhilafah.wordpress.com: 	Domain Name is not censored

appnationconference.com: 	Domain Name is not censored

attahreedmedia.wordpress.com: 	Domain Name is not censored

banglamail71.info: 	Domain Name is not censored

banglamail71.info: 	Domain Name is not censored

banglamail71.info: 	Domain Name is not censored

bdmusic23.com: 	Domain Name is not censored

bdmusic420.pw: 	Domain Name is not censored

bdmusic90.com: 	Domain Name is not censored

bdmusic90.com: 	Domain Name is not censored

bdmusicboss.net: 	Domain Name is not censored

bdnetwork24.com: 	Invalid Domain Name or Unknown Error Occured

bdpolitico.com: 	Domain Name is not censored

dailybdtimes.com: 	Domain Name is not censored

dailybdtimes.com: 	Domain Name is not censored

eisamay.indiatimes.com: 	Domain Name is not censored

fblive24.com: 	Domain Name is not censored

fursanmedia.wordpress.com: 	Domain Name is not censored

ht-bangladesh.info: 	Domain Name is not censored

moroccotoindonesia.wordpress.com: 	Domain Name is not censored

natokhd.com: 	Domain Name is not censored

rexwap.net: 	Domain Name is not censored

sheershanews.com: 	Domain Name is not censored

somoy.net: 	Domain Name is not censored

teertoday.com: 	Domain Name is not censored

ukbdtimes.com: 	Domain Name is not censored

womenchapter.com: 	Domain Name is not censored

www.appnationconference.com: 	Domain Name is not censored

www.banglapress.com: 	Domain Name is not censored

www.bdnetwork24.com: 	Invalid Domain Name or Unknown Error Occured

www.bdnetwork24.com: 	Invalid Domain Name or Unknown Error Occured

www.bdpolitico.com: 	Domain Name is not censored

www.bdtruenews24.com: 	Domain Name is not censored

www.bdtruenews24.com: 	Domain Name is not censored

www.dailystarbd.com: 	Invalid Domain Name or Unknown Error Occured

www.hizb-ut-tahrir.info: 	Domain Name is not censored

www.khilafah.com: 	Domain Name is not censored

www.mizzima.com: 	Domain Name is not censored

www.newbdmovie.net: 	Domain Name is not censored

www.newsonbd.net: 	Invalid Domain Name or Unknown Error Occured

www.rarenews24.com: 	Domain Name is not censored

www.rarenews24.com: 	Domain Name is not censored

www.rarenews24.space: 	Invalid Domain Name or Unknown Error Occured

www.roshikhakim.com: 	Invalid Domain Name or Unknown Error Occured

www.somoy.net: 	Domain Name is not censored

www.sonalibank-info.com: 	Invalid Domain Name or Unknown Error Occured

www.timesofassam.com: 	Domain Name is not censored

www.timesofassam.com: 	Domain Name is not censored

www.timesofassam.com: 	Domain Name is not censored

boubd.info: 	Invalid Domain Name or Unknown Error Occured

bou-bd.info: 	Domain Name is not censored

boubd.net: 	Invalid Domain Name or Unknown Error Occured

campustimes.press: 	Domain Name is not censored

chtnews24.com: 	Domain Name is not censored

chtnewsbd.com: 	Invalid Domain Name or Unknown Error Occured

cnnbd24.com: 	Domain Name is not censored

counterjihadreport.com: 	Domain Name is not censored

deshbhabona.com: 	Invalid Domain Name or Unknown Error Occured

dhakaentertainment.club: 	Invalid Domain Name or Unknown Error Occured

farjanalatablog.wordpress.com: 	Domain Name is not censored

farjanalatablog.wordpress.com: 	Domain Name is not censored

my-bd.com: 	Domain Name is not censored

openuniversitybd.org: 	Invalid Domain Name or Unknown Error Occured

parbattanews.com: 	Domain Name is not censored

qitaltube.blogspot.com: 	Domain Name is not censored

registerbd.com: 	Invalid Domain Name or Unknown Error Occured

revetm.com: 	Invalid Domain Name or Unknown Error Occured

royaledu-bd.com: 	Domain Name is not censored

royaluniversitybd.info: 	Domain Name is not censored

royaluniversitydhaka.com: 	Invalid Domain Name or Unknown Error Occured

royaluniversityedu.info: 	Invalid Domain Name or Unknown Error Occured

royaluniversityedubd.info: 	Invalid Domain Name or Unknown Error Occured

rtnbd.net: 	Invalid Domain Name or Unknown Error Occured

rtnbd.net: 	Invalid Domain Name or Unknown Error Occured

www.bd2bd.com: 	Invalid Domain Name or Unknown Error Occured

www.cht24.com: 	Invalid Domain Name or Unknown Error Occured

www.chtnews.com: 	Domain Name is not censored

www.dailycht.com: 	Invalid Domain Name or Unknown Error Occured

www.dailynayadiganta.com: 	Domain Name is not censored

www.dhakatimes24.com: 	Domain Name is not censored

www.economist.com: 	Domain Name is not censored

www.facebook.com: 	Domain Name is not censored

www.hillbd24.com: 	Domain Name is not censored

www.ipnewsbd.com: 	Domain Name is not censored

www.istishon.com: 	Domain Name is not censored

www.joybd24.info: 	Invalid Domain Name or Unknown Error Occured

www.newsbangla.net: 	Domain Name is not censored

www.newsbangla.net: 	Domain Name is not censored

www.newsbangla.net: 	Domain Name is not censored

www.news-bangla.net: 	Domain Name is not censored

www.newsinbd.net: 	Domain Name is not censored

www.newsonbd.net: 	Invalid Domain Name or Unknown Error Occured

www.poriborton.com: 	Domain Name is not censored

www.prothombangladesh.net: 	Domain Name is not censored

www.protichhobi.com: 	Domain Name is not censored

www.royalbd.info: 	Invalid Domain Name or Unknown Error Occured

www.rtnbd.net: 	Invalid Domain Name or Unknown Error Occured

